{
    "A": "6061",
    "B": "6070",
    "C": "4065",
    "D": "4078",
    "E": "4074",
    "F": "4061"
}